Name,ID,Math,Physics,Chemistry,Biology,Computing science,Total,Average,Grade
Alice,1001,85,78,92,88,90,433,86.6,B
Bob,1002,65,70,58,60,62,315,63.0,D
Charlie,1003,95,91,89,93,94,462,92.4,A
Diana,1004,72,75,70,68,74,359,71.8,C
Ethan,1005,88,84,90,86,85,433,86.6,B
Fiona,1006,55,60,58,62,59,294,58.8,F
George,1007,80,77,82,79,81,399,79.8,C
Hannah,1008,90,94,91,95,92,462,92.4,A
Ian,1009,45,50,48,42,47,232,46.4,F
Julia,1010,76,73,78,75,79,381,76.2,C
